5
9
#########
#       S
### #####
E       #
#########